0 0 0 0 0 2 0 0 0 0 0 0 0 0 4 0 0 0 0 0 0 5 0 0 0 0 1 2 4 0 0 0 0 1 0 0 1 0 0 6 5 0 0 0 0 2 0 4 0 0 0 0 0 2 0 0 0 0 0 2
2 0 0 0 0 1 0 0 0 4 2 0 0 0 0 0 2 2 0 0 0 1 0 0 0 0 0 2 0 0 0 0 0 2 5 0 0 0 0 0 0 0 2 5 5 0 0 0 0 0 0 0 0 2 0 0 0 0 2 0
0 0 0 1 0 0 0 0 0 0 0 0 0 0 2 0 0 0 5 0 0 0 0 0 0 0 0 0 0 4 5 5 0 0 0 4 0 0 0 0 0 2 0 0 4 2 0 0 0 0 1 0 1 1 0 1 0 0 0 0
5 0 4 0 0 2 2 4 0 1 0 0 0 0 0 0 0 0 2 5 2 0 0 0 0 0 0 0 0 0 0 0 0 0 0 0 0 2 0 3 2 0 0 0 0 0 0 1 0 0 0 0 0 0 0 4 1 5 0 0
0 0 0 0 0 5 0 0 0 0 0 0 0 0 0 0 0 0 0 0 0 0 0 2 0 1 0 0 2 0 0 0 0 1 0 0 0 0 2 0 0 5 0 0 0 0 0 4 0 0 0 0 0 0 0 0 2 0 0 0
0 0 0 2 0 3 2 0 0 0 5 0 0 1 0 5 0 1 1 2 0 4 0 0 0 5 0 2 0 0 5 0 0 0 0 0 1 0 2 0 6 0 2 2 0 0 0 2 4 0 0 0 0 0 3 0 0 0 0 0
2 0 2 0 0 0 0 2 0 0 0 2 0 0 0 0 0 1 1 0 0 0 0 0 0 4 0 1 0 0 2 0 0 0 0 0 0 0 0 2 0 0 4 0 2 0 0 0 1 0 0 0 0 6 0 0 0 2 0 0
0 0 0 2 0 0 0 0 0 2 0 2 0 0 0 1 4 0 0 0 0 2 2 0 0 0 0 1 0 0 0 0 0 0 0 1 0 0 4 0 2 0 5 0 0 0 0 0 1 0 0 2 0 0 0 0 0 0 0 0
0 0 0 0 2 0 0 2 0 0 0 0 0 0 4 0 4 0 0 2 5 0 2 0 0 0 0 4 0 5 2 4 0 0 0 0 0 0 0 0 0 0 0 2 0 0 0 0 0 0 2 0 0 0 0 5 0 0 0 1
0 0 0 0 2 2 0 0 0 0 0 4 0 0 0 0 1 0 0 0 0 0 0 0 0 1 2 0 0 0 0 5 0 0 0 0 0 0 0 0 0 1 0 0 0 2 0 0 2 0 0 1 4 0 0 0 2 0 0 0
0 0 0 0 0 0 0 0 4 2 0 0 0 0 0 4 0 0 2 0 0 0 0 0 0 0 0 0 0 0 0 0 0 0 0 0 2 0 0 0 0 0 0 0 2 0 0 0 0 0 0 0 0 0 5 4 0 0 0 0
0 0 4 0 0 0 0 2 2 0 0 0 0 2 0 2 0 0 0 0 0 0 0 0 4 0 0 0 0 0 0 0 0 2 2 0 5 0 0 0 2 0 0 0 0 0 0 0 0 2 0 0 2 0 0 2 0 1 4 0
0 2 0 0 0 0 0 0 0 0 0 0 0 0 0 0 5 0 0 0 0 1 2 1 2 2 0 0 4 0 0 0 2 2 0 0 0 0 0 4 0 0 0 0 0 0 0 0 0 0 2 0 1 0 0 0 0 0 0 4
0 0 0 0 1 2 0 0 0 2 0 5 0 0 0 0 0 0 0 0 0 1 0 4 0 0 0 0 2 0 0 0 0 5 0 0 0 0 2 0 5 0 0 1 2 0 0 0 0 4 0 2 0 0 1 0 0 1 0 0
0 0 0 0 0 5 0 0 0 0 2 0 0 0 2 0 0 2 0 0 0 0 0 5 4 0 1 0 2 4 2 0 1 0 1 6 0 0 0 0 0 0 2 0 0 0 0 0 0 0 0 2 2 0 1 0 0 0 0 0
2 0 0 1 0 0 0 0 0 4 1 0 0 0 3 0 2 3 0 0 0 0 0 0 0 0 0 0 0 0 0 0 0 0 0 0 4 0 0 0 2 0 3 0 0 0 0 0 0 4 0 0 0 2 1 1 2 0 0 0
2 0 0 1 2 0 4 0 0 0 0 2 0 0 0 0 0 2 0 4 0 0 0 0 2 2 0 0 0 0 0 6 0 0 4 2 0 0 0 0 0 0 5 2 0 0 1 0 0 2 0 0 0 0 2 0 0 0 0 2
0 0 0 0 0 0 0 0 0 0 0 0 0 0 0 0 5 0 0 0 0 5 0 0 4 0 0 0 0 0 2 6 0 0 0 4 0 0 0 0 0 0 2 4 0 0 0 0 0 0 0 0 0 0 4 0 0 0 0 0
0 0 0 0 0 5 0 0 0 0 0 0 0 0 0 0 0 0 0 0 0 0 0 5 4 0 0 0 0 0 0 0 1 0 0 2 0 0 5 0 0 0 1 0 0 2 0 0 0 0 0 1 2 1 1 0 5 0 0 0
0 0 0 0 0 2 0 0 0 0 0 0 0 4 2 1 0 0 0 1 0 0 0 0 4 0 4 5 0 0 0 0 0 0 0 0 0 0 0 0 0 0 4 0 5 2 0 0 0 0 1 0 0 2 0 2 0 0 0 0
0 0 0 5 1 0 0 0 0 0 2 0 4 0 0 0 0 0 0 1 0 0 0 0 4 5 1 0 1 0 3 0 0 0 0 3 0 0 0 0 2 0 0 0 0 0 0 0 0 0 0 0 0 2 0 0 0 0 2 0
0 0 0 0 0 0 5 0 0 0 0 0 0 0 5 0 0 0 4 5 1 5 0 0 0 0 0 0 5 0 0 0 0 0 0 0 0 0 0 0 0 1 0 0 0 2 0 0 0 0 2 0 1 5 0 0 4 0 2 0
5 0 0 0 0 0 0 0 0 0 0 0 0 0 0 0 0 0 5 0 0 0 0 0 0 1 0 0 0 0 0 4 0 1 2 0 0 1 0 0 0 0 2 5 0 0 4 0 0 0 0 0 1 0 0 0 0 0 1 0
5 5 0 0 0 0 0 0 5 0 0 0 0 0 5 1 2 0 0 0 5 0 0 0 0 0 0 5 0 0 0 1 0 0 1 0 2 0 0 0 0 1 0 2 2 0 0 2 0 0 0 2 0 0 0 0 0 0 0 4
0 0 0 0 0 0 0 0 0 2 2 0 0 4 0 1 0 0 1 0 0 0 6 0 0 0 2 5 0 1 0 1 0 0 0 2 0 5 0 0 0 0 0 0 0 0 0 2 0 0 1 0 0 0 0 0 0 0 0 0
0 0 0 0 0 2 2 0 0 0 2 0 2 4 0 1 0 2 0 0 0 0 0 0 0 2 0 0 0 0 0 0 0 0 4 0 0 0 0 0 0 0 0 2 4 0 0 1 0 2 0 0 0 0 0 0 0 0 0 0
0 0 2 0 0 0 0 0 5 0 0 0 0 0 0 0 0 2 0 0 0 0 0 5 6 0 0 0 0 0 0 0 2 2 1 0 0 0 0 1 0 0 2 0 0 0 0 0 0 0 0 0 2 0 5 0 0 0 1 0
1 0 0 1 0 0 0 2 0 0 0 0 0 0 0 0 5 0 0 0 0 0 0 0 0 2 0 0 1 0 0 2 0 1 0 0 5 0 0 0 0 2 0 0 0 0 0 0 0 4 0 0 4 0 1 0 0 0 0 0
0 4 0 0 0 0 2 0 3 0 0 0 0 2 0 0 0 2 0 0 0 0 0 2 5 0 5 0 0 0 0 2 0 0 0 2 2 0 4 0 0 0 2 0 4 2 0 0 5 2 0 2 0 0 0 0 0 5 0 0
2 6 2 0 0 0 6 0 0 0 0 0 0 0 0 0 0 2 2 0 0 0 0 0 0 2 0 0 2 2 0 0 2 6 0 0 0 0 2 0 0 0 0 0 0 0 2 0 0 0 2 0 0 0 0 0 0 0 0 0
2 0 0 0 0 2 0 0 0 1 0 0 0 0 5 1 0 5 0 5 0 0 1 0 0 0 0 2 0 0 0 0 2 0 0 0 0 0 6 4 0 0 0 0 0 0 0 0 1 0 5 0 0 0 0 0 0 1 0 1
0 0 0 0 0 0 2 4 0 0 2 5 0 5 2 0 0 0 5 0 0 0 0 0 4 6 0 2 0 1 2 0 0 0 2 0 0 5 0 0 4 0 0 0 0 0 2 0 0 2 5 0 0 0 0 0 2 0 0 0
0 2 0 0 5 0 0 0 0 0 0 0 2 0 4 4 0 0 4 0 4 0 0 0 0 0 2 0 0 0 0 0 0 4 0 2 5 0 0 0 0 0 0 0 0 5 0 2 0 0 0 0 0 0 0 0 0 0 0 5
0 0 0 0 0 0 0 2 5 0 0 0 0 2 0 0 0 0 2 0 0 0 0 0 0 0 0 2 2 0 0 0 0 4 0 0 0 0 2 0 5 0 0 0 4 0 0 0 0 0 0 2 4 2 0 4 2 0 0 0
4 0 4 4 0 4 1 0 2 0 0 0 0 1 0 5 0 5 0 0 0 0 0 0 0 2 0 0 0 0 0 5 0 0 0 0 0 0 0 2 0 4 0 0 0 1 1 1 0 0 4 1 0 0 0 0 0 0 0 1
0 0 0 2 0 0 0 0 6 0 0 0 0 4 0 5 2 0 0 0 0 0 0 0 0 0 0 0 0 0 1 0 0 0 5 5 0 5 4 3 0 0 0 1 0 0 0 5 0 0 0 0 0 2 1 2 0 0 0 0
0 0 0 0 0 2 0 0 0 0 0 4 0 2 0 2 0 0 2 0 0 0 0 1 0 0 2 0 0 4 0 0 6 0 0 0 0 0 0 0 0 0 0 4 1 0 0 4 0 0 1 0 2 0 0 0 0 4 0 0
5 0 0 0 0 0 2 0 0 1 0 0 0 0 0 0 0 2 0 1 0 0 0 0 5 0 0 1 0 0 0 0 0 0 0 2 4 0 0 0 0 0 4 0 2 0 0 2 0 0 0 0 0 5 0 0 0 0 0 4
0 0 5 2 0 4 4 0 0 0 0 0 0 0 2 0 0 0 0 0 0 0 2 4 0 0 0 5 6 0 2 0 0 0 0 0 0 0 0 5 0 0 0 0 0 0 0 0 0 2 0 0 0 5 0 0 2 0 2 5
2 0 0 2 0 0 0 0 0 5 0 0 2 4 0 0 1 0 0 0 2 0 0 1 0 0 0 0 4 0 2 0 0 0 0 2 0 0 1 5 0 0 0 4 0 0 2 0 0 0 0 0 0 0 0 2 0 4 1 0
0 6 1 1 0 0 0 0 0 0 0 0 5 0 0 0 0 0 0 0 0 0 0 0 0 0 0 0 0 0 0 1 0 0 0 2 0 0 4 0 0 0 1 1 0 2 1 4 0 0 0 0 0 0 0 0 1 2 2 0
0 0 0 0 0 0 5 0 0 0 0 0 0 0 0 0 0 0 0 5 0 0 0 0 0 0 1 0 0 2 0 0 0 2 0 0 2 0 1 0 0 0 0 0 0 0 0 5 0 0 4 0 0 6 6 0 2 0 0 2
0 0 0 1 0 4 0 0 4 0 0 2 0 0 0 1 0 0 1 0 0 0 0 2 1 0 1 0 0 0 0 0 1 0 0 0 4 0 1 0 0 0 0 0 0 0 0 0 0 0 0 0 4 0 0 4 2 0 0 2
0 0 0 0 0 1 0 0 0 0 0 5 2 1 0 0 1 0 4 0 0 0 0 0 0 0 0 5 5 0 0 2 6 0 0 1 0 0 0 2 1 0 0 0 0 0 2 0 0 0 2 0 0 0 5 0 0 0 0 0
0 0 0 0 0 0 4 0 0 0 0 0 0 0 0 0 0 0 0 0 0 0 0 0 0 0 0 0 0 0 0 0 0 0 0 0 0 2 0 2 2 0 0 0 0 0 0 0 0 0 0 0 4 0 1 0 0 0 0 5
1 4 0 2 0 0 0 0 0 4 4 0 2 0 0 1 0 0 0 0 0 0 0 0 0 0 0 0 4 0 0 0 0 2 0 0 0 0 0 2 0 6 0 0 0 0 0 0 2 0 0 0 0 1 4 2 0 4 5 0
0 0 0 2 0 0 0 0 0 0 0 0 0 0 0 0 2 0 6 0 4 0 0 0 0 0 0 0 0 0 0 0 4 0 0 0 2 0 2 0 5 0 0 0 0 1 0 0 0 0 0 1 0 0 0 0 0 0 0 0
0 0 2 0 0 1 0 0 0 2 2 0 0 5 0 5 0 4 0 0 0 0 0 0 0 0 0 0 0 0 0 0 0 0 0 0 0 0 0 0 4 0 0 0 4 0 4 0 0 0 0 0 0 0 2 0 4 0 0 0
0 0 0 0 0 0 2 0 0 0 0 5 0 0 2 4 2 0 0 0 6 0 0 0 0 0 0 0 0 0 0 0 0 0 0 5 0 0 5 2 0 0 0 0 0 5 1 0 0 0 0 0 0 0 0 0 0 0 0 0
0 0 0 0 5 0 0 2 2 0 0 0 2 2 0 2 0 4 4 4 0 0 0 0 0 0 0 0 0 2 0 0 4 0 0 1 0 0 0 0 4 0 0 0 0 0 0 0 2 2 0 2 0 0 0 0 0 0 0 0
0 0 0 0 0 0 0 0 0 0 0 0 2 0 0 0 0 1 2 0 1 0 0 0 0 0 0 2 0 0 0 0 0 0 0 4 0 2 0 2 0 0 0 0 0 0 2 4 0 0 0 0 0 0 0 2 1 0 0 0
0 1 0 0 0 4 4 0 0 4 0 0 0 0 2 0 0 0 4 0 0 5 4 0 0 0 4 0 4 0 0 4 0 0 0 0 0 0 0 0 0 0 0 0 0 2 0 0 0 0 0 4 0 2 0 5 0 0 0 4
0 0 1 0 5 0 0 0 0 0 0 0 0 0 0 0 0 0 0 0 0 0 0 0 0 5 2 0 1 0 0 0 2 0 0 0 0 5 0 0 0 0 0 0 0 0 2 0 2 0 0 0 0 0 0 0 0 0 0 0
0 0 0 0 0 0 0 0 0 2 0 0 0 0 0 6 0 0 2 0 0 0 4 0 0 2 5 0 0 0 5 2 0 0 4 0 0 2 0 2 2 0 0 0 2 0 0 4 0 0 0 0 0 0 5 0 0 0 0 0
4 0 0 0 0 0 0 0 0 0 0 2 0 0 0 0 0 0 0 0 0 0 0 0 0 0 0 0 0 0 0 0 2 0 0 4 0 6 5 0 1 0 0 0 0 0 0 0 2 0 4 0 0 2 0 5 2 1 0 0
0 0 2 2 0 0 0 0 0 2 0 1 0 0 0 0 0 0 1 0 0 5 2 0 0 0 0 0 0 0 0 0 4 2 0 0 0 0 2 2 0 0 0 0 2 0 2 0 0 0 0 0 0 4 4 0 2 0 0 0
2 2 0 0 0 0 0 0 0 0 0 2 0 0 2 0 2 0 0 0 0 0 0 0 0 0 0 2 0 0 2 0 0 0 0 0 0 0 0 0 0 0 0 0 0 0 0 0 0 0 0 0 0 0 2 0 0 0 0 2
1 1 0 4 0 0 5 0 0 5 0 4 0 0 0 0 0 0 1 0 0 0 2 0 0 0 0 0 0 0 0 0 0 0 0 0 0 0 4 0 0 0 0 0 0 0 0 2 0 0 0 0 0 2 0 0 0 2 0 4
2 0 0 0 0 0 0 0 0 4 0 0 5 0 0 0 0 0 0 0 2 0 0 0 4 0 1 0 4 1 0 0 0 0 0 0 0 0 4 0 2 0 0 0 0 0 4 2 0 2 0 0 0 0 0 0 0 0 0 0
0 0 0 0 0 2 0 0 2 0 0 2 0 6 0 1 4 0 2 0 0 0 0 0 0 0 0 0 2 0 2 2 0 0 0 0 5 0 0 5 0 0 0 2 0 0 0 0 0 0 0 0 0 2 0 0 0 0 2 0
